PPPPPPPPPPPPPPPPPPPPGBBBBBBBBBBCCCCCCCCC
PZ[EEEEEEPAAAAAAARAPFBBBBBBBBBBCCCCCCCCC
PEEEUEEEEAAAAQAAAAAPBBBBBBBBBBBCCCCCCCCC
PEEEWEEEEAAAAAAAAASPBBBBBBBBBBBCCCCCCCCC
PEEEEEEEEPAAAAAAAATPBBBBBBBBBBBCCCCCCCCC
PPPPPEEEPPPPPAAAPPPPBBBBBBBBBBBCCCCCCCCC
PAAAAAAAAAAAAAAAAAAPBBBBBBBBBBBCCCCCCCCC
PAAAAHHHAAAAAAAAAAAPBBBBBBBBBBBCCCCCCCCC
PAAHHHHHHHHHHHHHAAAPBBBBBBBBBBBCCCCCCCCC
PAAHHHHHHHHHHHHHAAAABBBBBBBBBBBCCCCCCCCC
PAAAAAAAAAAAHHHHAAAABBBBBBBBBBBCCCCCCCCC
PPPPAAPPPPAAAAAAAAAPBBBBBBBBBBBCCCCCCCCC
PAAAAAAAAPAAAAAAAAAPBBBBBBBBBBBCCCCCCCCC
PAAAAAAVAPAAAAAAAAAPBBBBBBBBBBBCCCCCCCCC
PAAAAAAAAPAAAAAAAAAPBBBBBBBBBBBCCCCCCCCC
PAAAAAAAAPAAAAAAAAAPBBBBBBBBBBBCCCCCCCCC
PAAAASAAAPAAAAXAAAAPBBBBBBBBBBBCCCCCCCCC
PAAAATAAAPAAAAAAAAAPBBBBBBBBBBBCCCCCCCCC
PRAAAAAAAPAAAAYAAAAPBBBBBBBBBBBCCCCCCCCC
PPPPPPPPPPPPPPPPPPPPBBBBBBBBBBBCCCCCCCCC
