PPPPPPPPPPPPPPPPPPPPGBBBBBBBBBCCCCCCCCCC
PZ[EEEEEEPAAAAAAARAPFBBBBBBBBCCCCCCCCCCC
PEEEUEEEEAAAAQAAAAAPBBBBBBBBBBCCCCCCCCCC
PEEEWEEEEAAAAAAAAASPBBBBBBBBBBCCCCCCCCCC
PEEEEEEEEPAAAAAAAATPBBBBBBBBBBCCCCCCCCCC
PPPPPEEEPPPPPAAAPPPPBBBBBBBBCCCCCCCCCCCC
PAAAAAAAAAAAAAAAAAAPBBBBBBBBBBCCCCCCCCCC
PAAAAHHHAAAAAAAAAAAPBBBBBBBBBBCCCCCCCCCC
PAAHHHHHHHHHHHHHAAAPBBBBBBBBBBCCCCCCCCCC
PAAHHHHHHHHHHHHHAAAABBBBBBBBBBCCCCCCCCCC
PAAAAAAAAAAAHHHHAAAABBBBBBBBBBCCCCCCCCCC
PPPPAAPPPPAAAAAAAAAPBBBBBBBBBBCCCCCCCCCC
PAAAAAAAAPAAAAAAAAAPBBBBBBBBBBCCCCCCCCCC
PAAAAAAVAPAAAAAAAAAPBBBBBBBBBBCCCCCCCCCC
PAAAAAAAAPAAAAAAAAAPBBBBBBBBBBCCCCCCCCCC
PAAAAAAAAPAAAAAAAAAPBBBBBBBBBBCCCCCCCCCC
PAAAAAAAAPAAAAXAAAAPBBBBBBBBBBCCCCCCCCCC
PAAAASAAAPAAAAAAAAAPBBBBBBBBBBCCCCCCCCCC
PRAAATAAAPAAAAYAAAAPBBBBBBBBBBCCCCCCCCCC
PPPPPPPPPPPPPPPPPPPPBBBBBBBBBBCCCCCCCCCC
