PPPPPPPPPPPPPPPPPPPPGBBBBBBBBCCCCCCC
PZ[EEEEEEPAAAAAAARAPFBBBBBBBBCCCCCCC
PEEEUEEEEAAAAQAAAAAPBBBIIBBBBCCCCCCC
PEEEWEEEEAAAAAAAAASPBBBBBBBBBCCCCCCC
PEEEEEEEEPAAAAAAAATPBBB\BBBBBCCCCCCC
PPPPPEEEPPPPPAAAPPPPBBBBBBBBBCCCCCCC
PAAAAAAAAAAAAAAAAAAPBBBBBBBBBCCCCCCC
PAAAAHHHAAAAAAAAAAAPBBBBBBBBBCCCCCCC
PAAHHHHHHHHHHHHHAAAPBBBBBBBBBCCCCCCC
PAAHHHHHHHHHHHHHAAAABBBBBBBBBCCCCCCC
PAAAAAAAAAAAHHHHAAAABBBBBBBBBCCCCCCC
PPPPAAPPPPAAAAAAAAAPBBBBBBBBBCCCCCCC
PAAAAAAAAPAAAAAAAAAPBBBBBBBBBCCCCCCC
PAAAAAAVAPAAAAAAAAAPBBBBBBBBBCCCCCCC
PAAAAAAAAPAAAAAAAAAPBBB\BBBBBCCCCCCC
PAAAAAAAAPAAAAAAAAAPBBBBBBBBBCCCCCCC
PAAAASAAAPAAAAXAAAAPBBBBBBBBBCCCCCCC
PAAAATAAAPAAAAAAAAAPBBBBBBBBBCCCCCCC
PRAAAAAAAPAAAAYAAAAPBBBIIBBBBCCCCCCC
PPPPPPPPPPPPPPPPPPPPBBBBBBBBBCCCCCCC
