AAAAAAAAAAAAAAAAAAADBBBBBBBBBBCCCCCCCCCC
AAAAAAAAAAAAAAAAAAADBBBBBBBBBBCCCCCCCCCC
AAAAAAAAAAAAAAAAAAADBBBBBBBBBBCCCCCCCCCC
AAAAAAAAAAAAAAAAAAADBBBBBBBBBBCCCCCCCCCC
AAAAAAAAAAAAAAAAAAADBBBBBBBBBBCCCCCCCCCC
AAAAAADDDAADAAAAABBBBBBBBBBBCCCCCCCCCCCC
AAAAAAAADAAADAAAAAABBBBBBBBBBBCCCCCCCCCC
AAAAAAAAAAABAAAAAAABBBBBBBBBBBCCCCCCCCCC
AAAAAAAADAADDDAAAAABBBBBBBBBBBCCCCCCCCCC
AAAAAAAADAAAAAAAAAABBBBBBBBBBBCCCCCCCCCC
AAAAAAAAAAAAAAAAAAABBBBBBBBBBBCCCCCCCCCC
AAAAAAAAAAAAAAAAAAABBBBBBBBBBBCCCCCCCCCC
AAAAAAAAAAAAAAAAAAABBBBBBBBBBBCCCCCCCCCC
AAAAAAAAAAAAAAAAAAABBBBBBBBBBBCCCCCCCCCC
AAAAAAAAAAAAAAAAAAADBBBBBBBBBBCCCCCCCCCC
AAAAAAAAAAAAAAAAAAADBBBBBBBBBBCCCCCCCCCC
AAAAAAAAAAAAAAAAAAADBBBBBBBBBBCCCCCCCCCC
AAAAAAAAAAAAAAAAAAADBBBBBBBBBBCCCCCCCCCC
AAAAAAAAAAAAAAAAAAADBBBBBBBBBBCCCCCCCCCC
AAAAAAAAAAAAAAAAAAADBBBBBBBBBBCCCCCCCCCC
